1111111111111111
1PCCCC0000000001
1010101000011111
100000000001C0C1
1000000021010101
1000002010010101
1000000000010001
12E0000000001021
1000000011110201
1000000010100211
1C10000000011111
1111111010101111
1111111111111111
1111111111111111